11111
1E001
100C1
10PC1
11111 
