11111111111111111
100001010P00001C1
10100101000010101
101C0101000010101
100E00000C00C0001
11111111111111111
