11111111111111111
1E0000000000000C1
10100101001000001
1P100100101010101
100000000C00C0001
11111111111111111
